沈小子=Thẩm tiểu tử
青丘国主=Thanh Khâu quốc chủ
沈某=Thẩm mỗ
偃兄=Yển huynh
白兄=Bạch huynh
沈兄=Thẩm huynh
偃, 白=Yển, Bạch
白道友=Bạch đạo hữu
聂道友=Nhiếp đạo hữu
沈道友=Thẩm đạo hữu
火道友=Hỏa đạo hữu
聂, 白, 偃=Nhiếp, Bạch, Yển
袁道友=Viên đạo hữu
狐道友=Hồ đạo hữu
猿兄=Viên huynh
有苏谋主=Hữu Tô mưu chủ
狐兄=Hồ huynh
长安, 天机=Trường An, Thiên Cơ
姜兄=Khương huynh
天机下卷=Thiên Cơ hạ quyển
敖兄=Ngao huynh
马道友=Mã đạo hữu
袁国师=Viên quốc sư
程国公=Trình quốc công
薛道友=Tiết đạo hữu
袁某=Viên mỗ
李某=Lý mỗ
人仙=Nhân Tiên
妖, 魔=Yêu, Ma
李道友=Lý đạo hữu
周道友=Chu đạo hữu
偃师兄=Yển sư huynh
陆兄=Lục huynh
薛大人=Tiết đại nhân
沈小友=Thẩm tiểu hữu
聂姑娘=Nhiếp cô nương
薛某=Tiết mỗ
陆贤侄=Lục hiền chất
妖魔=Yêu Ma
仙魔=Tiên Ma
黑兄=Hắc huynh
姓沈=họ Thẩm
名落=tên Lạc
朱道友=Chu đạo hữu
水喰族人=Thủy San tộc nhân
敖道友=Ngao đạo hữu
朱兄=Chu huynh
沈前辈=Thẩm tiền bối
杜道友=Đỗ đạo hữu
元道友=Nguyên đạo hữu
元某=Nguyên mỗ
敖某=Ngao mỗ
金兄=Kim huynh
金某=Kim mỗ
金道友=Kim đạo hữu
沈贼=Thẩm tặc
孙婆婆=Tôn bà bà
沈大哥=Thẩm đại ca
柳姑娘=Liễu cô nương
紫先生=Tử tiên sinh
聂仙子=Nhiếp tiên tử
火前辈=Hỏa tiền bối
沉兄=Thẩm huynh
沉某=Thẩm mỗ
沉道友=Thẩm đạo hữu
沉小子=Thẩm tiểu tử
沉前辈=Thẩm tiền bối
猿道友=Viên đạo hữu
老向=lão Hướng
柳统领=Liễu thống lĩnh
马元帅=Mã nguyên soái
流元帅=Lưu nguyên soái
孙道友=Tôn đạo hữu
白祖师=Bạch tổ sư
白盟主=Bạch minh chủ
聂小友=Nhiếp tiểu hữu
卢道友=Lô đạo hữu
白前辈=Bạch tiền bối
黑白前辈=Hắc Bạch tiền bối
黑白道友=Hắc Bạch đạo hữu
孔某=Khổng mỗ
万圣公主=Vạn Thánh công chúa
黑莲道人=Hắc Liên đạo nhân
楚河汉界=Sở hà Hán giới
黑白真君=Hắc Bạch chân quân
古道友=Cổ đạo hữu
空寂禅师=Không Tịch thiền sư
黄木上人=Hoàng Mộc thượng nhân
空寂和尚=Không Tịch hòa thượng
青莲仙子=Thanh Liên tiên tử
空度禅师=Không Độ thiền sư
白师侄=Bạch sư chất
古师侄=Cổ sư chất
巫道友=Vu đạo hữu
镇元道友=Trấn Nguyên đạo hữu
众魔族=đám Ma Tộc
镇元大仙=Trấn Nguyên đại tiên
菩提老祖=Bồ Đề lão tổ
地涌夫人=Địa Dũng phu nhân
菩提道友=Bồ Đề đạo hữu
玲珑姐姐=Linh Lung tỷ tỷ
聂, 马=Nhiếp, Mã
韩母=Hàn mẫu
韩父=Hàn phụ
姓韩=họ Hàn
名立=tên Lập
张叔=Trương thúc
韩家=Hàn gia
韩胖子=Hàn béo mập
老韩=lão Hàn
七绝上人=Thất Tuyệt thượng nhân
王护法=Vương hộ pháp
韩理=Hàn lý
舞少爷=Vũ thiếu gia
舞大哥=Vũ đại ca
王老弟=Vương lão đệ
岳堂主=Nhạc đường chủ
墨大夫=Mặc đại phu
顾副堂主=Cố phó đường chủ
李教习=Lý giáo tập
马副门主=Mã phó môn chủ
墨老=Mặc lão
张哥=Trương ca
王大门主=Vương đại môn chủ
王门主=Vương môn chủ
王胖子=Vương béo mập
张大公子=Trương đại công tử
钟师兄=Chung sư huynh
燕某=Yến mỗ
王师侄=Vương sư chất
王家=Vương gia
嫣儿=Yên nhi
燕家=Yến gia
燕师弟=Yến sư đệ
钟姓=họ Chung
燕姓=họ Yến
韩大长老=Hàn đại trưởng lão
厉师兄=Lệ sư huynh
韩师兄=Hàn sư huynh
韩师弟=Hàn sư đệ
厉虎=Lệ hổ
林道友=Lâm đạo hữu
南蛮语=Nam Man ngữ
南蛮子=Nam Man tử
从中原=từ Trung Nguyên
中原人=người Trung Nguyên
木灵根=Mộc linh căn
水灵根=Thủy linh căn
火灵根=Hỏa linh căn
金灵根=Kim linh căn
伪灵根=Ngụy linh căn
双灵根=Song linh căn
三灵根=Tam linh căn
四灵根=Tứ linh căn
天灵根=Thiên linh căn
异灵根=Dị linh căn
南疆人=người Nam Cương
镇南将军=Trấn Nam tướng quân
玉壶仙长=Ngọc Hồ tiên trưởng
李公公=Lý công công
玉壶道长=Ngọc Hồ đạo trưởng
玉壶老道=Ngọc Hồ lão đạo
袁兄=Viên huynh
钟家=Chung gia
青伯=Thanh bá
韩某=Hàn mỗ
徐姓=họ Từ
徐某=Từ mỗ
回天南=hồi Thiên Nam
林仙子=Lâm tiên tử
徐兄=Từ huynh
鹿长老=Lộc trưởng lão
乌道友=Ô đạo hữu
齐兄=Tề huynh
乌兄=Ô huynh
齐某=Tề mỗ
雷灵根=Lôi linh căn
影灵根=Ảnh linh căn
毒灵根=Độc linh căn
金爷=Kim gia
楚长老=Sở trưởng lão
三洞主=Tam động chủ
方师兄=Phương sư huynh
袁师弟=Viên sư đệ
对方格=đối Phương Cách
陈师姐=Trần sư tỷ
